#: grass, G: green gem
#G#############
##########G####
###############
#G##########G##
###############
######G########
############G##
########G######
###############
#P######G######
############G##
