#: grass, G: green gem
#G##B##########
####B#####G####
####B##########
#G##########G##
###############
######G########
############G##
########G######
############K##
#P##B###G######
############G##
