#: grass, G: green gem
#G#######G##G##
###BBB#G#######
####KB####B#G##
#####B#G####G##
#G###B###G#####
####G###G#B####
#G##########G##
#####G####G####
###############
#P######G######
####G#######G##
