#: grass, G: green gem
#G#######G##G##
###B###G#######
####K#####B#G##
#######G####G##
#G#######G#####
####G###G######
#G##########G##
#####G####G####
###############
#P######G######
####G#######G##
